{
    "id": "bridge-crossing",
    "name": "Bridge Crossing",
    "width": 12,
    "height": 10,
    "tileSize": 16,
    "tilesetId": "overworld",
    "spawnPoint": {
        "x": 6,
        "y": 8
    },
    "layers": {
        "ground": [
            [1, 1, 1, 1, 1, 1, 1, 1, 1, 2, 2, 2],
            [1, 1, 1, 1, 1, 1, 1, 1, 1, 2, 2, 2],
            [1, 1, 1, 1, 1, 1, 1, 1, 1, 2, 2, 2],
            [1, 1, 1, 1, 1, 1, 1, 1, 1, 2, 2, 2],
            [1, 1, 1, 1, 1, 1, 1, 1, 1, 2, 2, 2],
            [1, 1, 1, 1, 1, 1, 1, 1, 1, 2, 2, 2],
            [1, 1, 1, 1, 1, 1, 1, 1, 1, 2, 2, 2],
            [1, 1, 1, 1, 1, 1, 1, 1, 1, 2, 2, 2],
            [1, 1, 1, 1, 1, 1, 1, 1, 1, 2, 2, 2],
            [1, 1, 1, 1, 1, 1, 1, 1, 1, 2, 2, 2]
        ],
        "decoration": [
            [0, 0, 0, 0, 0, 0, 0, 0, 0, 0, 0, 0],
            [0, 0, 3, 3, 3, 0, 0, 3, 3, 3, 0, 0],
            [0, 0, 3, 3, 3, 0, 0, 3, 3, 3, 0, 0],
            [0, 0, 3, 3, 3, 0, 0, 3, 3, 3, 0, 0],
            [0, 0, 3, 3, 3, 0, 0, 3, 3, 3, 0, 0],
            [0, 0, 3, 3, 3, 0, 0, 3, 3, 3, 0, 0],
            [0, 0, 3, 3, 3, 0, 0, 3, 3, 3, 0, 0],
            [0, 0, 3, 3, 3, 0, 0, 3, 3, 3, 0, 0],
            [0, 0, 3, 3, 3, 0, 0, 3, 3, 3, 0, 0],
            [0, 0, 0, 0, 0, 0, 0, 0, 0, 0, 0, 0]
        ],
        "collision": [
            [1, 1, 1, 1, 1, 1, 1, 1, 1, 1, 1, 1],
            [1, 0, 0, 1, 1, 1, 1, 1, 1, 1, 0, 1],
            [1, 0, 0, 1, 1, 1, 1, 1, 1, 1, 0, 1],
            [1, 0, 0, 1, 1, 1, 1, 1, 1, 1, 0, 1],
            [1, 0, 0, 1, 1, 1, 1, 1, 1, 1, 0, 1],
            [1, 0, 0, 1, 1, 1, 1, 1, 1, 1, 0, 1],
            [1, 0, 0, 1, 1, 1, 1, 1, 1, 1, 0, 1],
            [1, 0, 0, 1, 1, 1, 1, 1, 1, 1, 0, 1],
            [1, 0, 0, 1, 1, 1, 1, 1, 1, 1, 0, 1],
            [1, 1, 1, 1, 1, 1, 1, 1, 1, 1, 1, 1]
        ]
    },
    "npcs": [
        {
            "id": "bridge_guard",
            "name": "Bridge Guard",
            "mapId": "bridge-crossing",
            "x": 4,
            "y": 3,
            "facingDirection": "North"
        },
        {
            "id": "traveler",
            "name": "Traveler",
            "mapId": "bridge-crossing",
            "x": 9,
            "y": 2,
            "facingDirection": "South"
        }
    ],
    "transitions": [
        {
            "fromMapId": "bridge-crossing",
            "fromTile": {
                "x": 6,
                "y": 0
            },
            "toMapId": "riverside-village",
            "toTile": {
                "x": 10,
                "y": 0
            },
            "requiredFlag": "old_watermill_cleared",
            "oneWayReason": "Bridge crossing is an unlock gate into the next region."
        }
    ]
}
