{
  "id": "frostveil-path",
  "name": "Frostveil Path",
  "width": 20,
  "height": 15,
  "tileSize": 16,
  "tilesetId": "overworld",
  "spawnPoint": { "x": 5, "y": 13 },
  "layers": {
    "ground": [
      [2, 2, 2, 2, 2, 2, 2, 2, 2, 2, 9, 9, 9, 9, 9, 9, 9, 9, 9, 9],
      [2, 9, 9, 9, 9, 9, 2, 2, 2, 2, 9, 9, 10, 10, 10, 9, 9, 9, 9, 9],
      [2, 9, 9, 10, 10, 9, 2, 9, 9, 2, 9, 9, 10, 10, 10, 9, 9, 9, 2, 2],
      [2, 9, 9, 10, 10, 9, 2, 9, 9, 2, 9, 9, 9, 9, 9, 9, 9, 9, 2, 9],
      [2, 2, 2, 2, 2, 2, 2, 9, 9, 2, 2, 2, 2, 2, 2, 9, 9, 9, 2, 9],
      [9, 9, 9, 9, 9, 9, 2, 9, 9, 9, 9, 10, 10, 10, 2, 9, 9, 9, 2, 9],
      [9, 9, 9, 10, 10, 9, 2, 2, 2, 2, 9, 10, 10, 10, 2, 2, 2, 2, 2, 9],
      [9, 9, 9, 10, 10, 9, 9, 9, 9, 2, 9, 9, 9, 9, 9, 9, 9, 9, 2, 9],
      [9, 9, 9, 9, 9, 9, 9, 9, 9, 2, 2, 2, 2, 2, 2, 9, 9, 9, 2, 9],
      [9, 9, 9, 9, 10, 10, 10, 9, 9, 9, 9, 9, 9, 9, 2, 9, 9, 9, 2, 9],
      [9, 9, 9, 9, 10, 10, 10, 9, 9, 9, 9, 10, 10, 9, 2, 2, 2, 2, 2, 9],
      [9, 9, 9, 9, 9, 9, 9, 9, 2, 2, 2, 10, 10, 9, 9, 9, 9, 9, 9, 9],
      [9, 9, 9, 9, 9, 9, 9, 9, 2, 9, 2, 2, 2, 2, 2, 2, 9, 9, 9, 9],
      [9, 9, 9, 9, 9, 2, 2, 2, 2, 9, 9, 9, 9, 9, 9, 2, 9, 9, 9, 9],
      [9, 9, 9, 9, 9, 2, 9, 9, 9, 9, 9, 9, 9, 9, 9, 9, 9, 9, 9, 9]
    ],
    "decoration": [
      [0, 0, 0, 0, 0, 0, 0, 0, 0, 0, 0, 0, 0, 0, 0, 0, 0, 0, 0, 0],
      [0, 0, 0, 0, 0, 0, 0, 0, 0, 0, 0, 0, 0, 0, 0, 0, 0, 0, 0, 0],
      [0, 0, 0, 0, 0, 0, 0, 0, 0, 0, 0, 0, 0, 0, 0, 0, 0, 0, 0, 0],
      [0, 0, 0, 0, 0, 0, 0, 0, 0, 0, 0, 0, 0, 0, 0, 0, 0, 0, 0, 0],
      [0, 0, 0, 0, 0, 0, 0, 0, 0, 0, 0, 0, 0, 0, 0, 0, 0, 0, 0, 0],
      [0, 0, 0, 0, 0, 0, 0, 0, 0, 0, 0, 0, 0, 0, 0, 0, 0, 0, 0, 0],
      [0, 0, 0, 0, 0, 0, 0, 0, 0, 0, 0, 0, 0, 0, 0, 0, 0, 0, 0, 0],
      [0, 0, 0, 0, 0, 0, 0, 0, 0, 0, 0, 0, 0, 0, 0, 0, 0, 0, 0, 0],
      [0, 0, 0, 0, 0, 0, 0, 0, 0, 0, 0, 0, 0, 0, 0, 0, 0, 0, 0, 0],
      [0, 0, 0, 0, 0, 0, 0, 0, 0, 0, 0, 0, 0, 0, 0, 0, 0, 0, 0, 0],
      [0, 0, 0, 0, 0, 0, 0, 0, 0, 0, 0, 0, 0, 0, 0, 0, 0, 0, 0, 0],
      [0, 0, 0, 0, 0, 0, 0, 0, 0, 0, 0, 0, 0, 0, 0, 0, 0, 0, 0, 0],
      [0, 0, 0, 0, 0, 0, 0, 0, 0, 0, 0, 0, 0, 0, 0, 0, 0, 0, 0, 0],
      [0, 0, 0, 0, 0, 0, 0, 0, 0, 0, 0, 0, 0, 0, 0, 0, 0, 0, 0, 0],
      [0, 0, 0, 0, 0, 0, 0, 0, 0, 0, 0, 0, 0, 0, 0, 0, 0, 0, 0, 0]
    ],
    "collision": [
      [1, 1, 1, 1, 1, 1, 1, 1, 1, 1, 1, 1, 1, 1, 1, 1, 1, 1, 1, 1],
      [1, 0, 0, 0, 0, 0, 0, 0, 0, 0, 0, 0, 0, 0, 0, 0, 0, 0, 0, 1],
      [1, 0, 0, 0, 0, 0, 0, 0, 0, 0, 0, 0, 0, 0, 0, 0, 0, 0, 0, 0],
      [1, 0, 0, 0, 0, 0, 0, 0, 0, 0, 0, 0, 0, 0, 0, 0, 0, 0, 0, 1],
      [1, 0, 0, 0, 0, 0, 0, 0, 0, 0, 0, 0, 0, 0, 0, 0, 0, 0, 0, 1],
      [1, 0, 0, 0, 0, 0, 0, 0, 0, 0, 0, 0, 0, 0, 0, 0, 0, 0, 0, 1],
      [1, 0, 0, 0, 0, 0, 0, 0, 0, 0, 0, 0, 0, 0, 0, 0, 0, 0, 0, 1],
      [1, 0, 0, 0, 0, 0, 0, 0, 0, 0, 0, 0, 0, 0, 0, 0, 0, 0, 0, 1],
      [1, 0, 0, 0, 0, 0, 0, 0, 0, 0, 0, 0, 0, 0, 0, 0, 0, 0, 0, 1],
      [1, 0, 0, 0, 0, 0, 0, 0, 0, 0, 0, 0, 0, 0, 0, 0, 0, 0, 0, 1],
      [1, 0, 0, 0, 0, 0, 0, 0, 0, 0, 0, 0, 0, 0, 0, 0, 0, 0, 0, 1],
      [1, 0, 0, 0, 0, 0, 0, 0, 0, 0, 0, 0, 0, 0, 0, 0, 0, 0, 0, 1],
      [1, 0, 0, 0, 0, 0, 0, 0, 0, 0, 0, 0, 0, 0, 0, 0, 0, 0, 0, 1],
      [1, 0, 0, 0, 0, 0, 0, 0, 0, 0, 0, 0, 0, 0, 0, 0, 0, 0, 0, 1],
      [1, 1, 1, 1, 1, 0, 1, 1, 1, 1, 1, 1, 1, 1, 1, 1, 1, 1, 1, 1]
    ]
  },
  "transitions": [
    {
      "fromMapId": "frostveil-path",
      "fromTile": { "x": 5, "y": 14 },
      "toMapId": "mountain-lift",
      "toTile": { "x": 5, "y": 1 }
    },
    {
      "fromMapId": "frostveil-path",
      "fromTile": { "x": 19, "y": 2 },
      "toMapId": "snowbell-lodge",
      "toTile": { "x": 1, "y": 6 }
    }
  ]
}
