{
  "id": "route-1",
  "name": "Route 1",
  "width": 22,
  "height": 14,
  "tileSize": 16,
  "tilesetId": "overworld",
  "spawnPoint": { "x": 10, "y": 12 },
  "layers": {
    "ground": [
      [1,1,1,1,1,1,1,1,1,1,2,1,1,1,1,1,1,1,1,1,1,1],
      [1,1,1,1,1,1,1,1,1,1,2,1,1,1,1,1,1,1,1,1,1,1],
      [1,1,1,1,1,1,1,1,1,1,2,1,1,1,1,1,1,1,1,1,1,1],
      [1,1,1,1,1,1,1,1,1,1,2,1,1,1,1,1,1,1,1,1,1,1],
      [1,1,1,1,1,1,1,1,1,1,2,1,1,1,1,1,1,1,1,1,1,1],
      [1,1,1,1,1,1,1,1,1,1,2,1,1,1,1,1,1,1,1,1,1,1],
      [1,1,1,1,1,1,1,1,1,1,2,1,1,1,1,1,1,1,1,1,1,1],
      [1,1,1,1,1,1,1,1,1,1,2,1,1,1,1,1,1,1,1,1,1,1],
      [1,1,1,1,1,1,1,1,1,1,2,1,1,1,1,1,1,1,1,1,1,1],
      [1,1,1,1,1,1,1,1,1,1,2,1,1,1,1,1,1,1,1,1,1,1],
      [1,1,1,1,1,1,1,1,1,1,2,1,1,1,1,1,1,1,1,1,1,1],
      [1,1,1,1,1,1,1,1,1,1,2,1,1,1,1,1,1,1,1,1,1,1],
      [1,1,1,1,1,1,1,1,1,1,2,1,1,1,1,1,1,1,1,1,1,1],
      [1,1,1,1,1,1,1,1,1,1,2,1,1,1,1,1,1,1,1,1,1,1]
    ],
    "decoration": [
      [6,6,6,6,6,6,6,6,6,6,0,6,6,6,6,6,6,6,6,6,6,6],
      [6,0,0,0,0,0,0,0,0,0,0,0,0,0,0,0,0,0,0,0,0,6],
      [6,0,0,0,0,0,0,0,0,0,0,0,0,0,0,0,0,0,0,0,0,6],
      [6,0,0,0,0,0,0,0,0,0,0,0,0,0,0,0,0,0,0,0,0,6],
      [6,0,0,0,0,0,0,0,0,0,0,0,0,0,0,0,0,0,0,0,0,6],
      [6,0,0,0,0,0,0,0,0,0,0,0,0,0,0,0,0,0,0,0,0,6],
      [6,0,0,0,0,0,0,0,0,0,0,0,0,0,0,0,0,0,0,0,0,6],
      [6,0,0,0,0,0,0,0,0,0,0,0,0,0,0,0,0,0,0,0,0,6],
      [6,0,0,0,0,0,0,0,0,0,0,0,0,0,0,0,0,0,0,0,0,6],
      [6,0,0,0,0,0,0,0,0,0,0,0,0,0,0,0,0,0,0,0,0,6],
      [6,0,0,0,0,0,0,0,0,0,0,0,0,0,0,0,0,0,0,0,0,6],
      [6,0,0,0,0,0,0,0,0,0,0,0,0,0,0,0,0,0,0,0,0,6],
      [6,0,0,0,0,0,0,0,0,0,0,0,0,0,0,0,0,0,0,0,0,6],
      [6,6,6,6,6,6,6,6,6,6,0,6,6,6,6,6,6,6,6,6,6,6]
    ],
    "collision": [
      [1,1,1,1,1,1,1,1,1,1,0,1,1,1,1,1,1,1,1,1,1,1],
      [1,0,0,0,0,0,0,0,0,0,0,0,0,0,0,0,0,0,0,0,0,1],
      [1,0,0,0,0,0,0,0,0,0,0,0,0,0,0,0,0,0,0,0,0,1],
      [1,0,0,0,0,0,0,0,0,0,0,0,0,0,0,0,0,0,0,0,0,1],
      [1,0,0,0,0,0,0,0,0,0,0,0,0,0,0,0,0,0,0,0,0,1],
      [1,0,0,0,0,0,0,0,0,0,0,0,0,0,0,0,0,0,0,0,0,1],
      [1,0,0,0,0,0,0,0,0,0,0,0,0,0,0,0,0,0,0,0,0,1],
      [1,0,0,0,0,0,0,0,0,0,0,0,0,0,0,0,0,0,0,0,0,1],
      [1,0,0,0,0,0,0,0,0,0,0,0,0,0,0,0,0,0,0,0,0,1],
      [1,0,0,0,0,0,0,0,0,0,0,0,0,0,0,0,0,0,0,0,0,1],
      [1,0,0,0,0,0,0,0,0,0,0,0,0,0,0,0,0,0,0,0,0,1],
      [1,0,0,0,0,0,0,0,0,0,0,0,0,0,0,0,0,0,0,0,0,1],
      [1,0,0,0,0,0,0,0,0,0,0,0,0,0,0,0,0,0,0,0,0,1],
      [1,1,1,1,1,1,1,1,1,1,0,1,1,1,1,1,1,1,1,1,1,1]
    ]
  },
  "transitions": [
    {
      "fromMapId": "route-1",
      "fromTile": { "x": 10, "y": 13 },
      "toMapId": "starter-town",
      "toTile": { "x": 10, "y": 1 }
    }
  ]
}
