{
  "id": "mountain-lift",
  "name": "Mountain Lift",
  "width": 10,
  "height": 8,
  "tileSize": 16,
  "tilesetId": "overworld",
  "spawnPoint": { "x": 5, "y": 7 },
  "layers": {
    "ground": [
      [3, 3, 3, 3, 3, 1, 3, 3, 3, 3],
      [3, 5, 5, 5, 5, 5, 5, 5, 5, 3],
      [3, 5, 8, 8, 5, 5, 8, 8, 5, 3],
      [3, 5, 8, 8, 5, 5, 8, 8, 5, 3],
      [3, 5, 5, 5, 10, 10, 5, 5, 5, 3],
      [3, 5, 5, 5, 10, 10, 5, 5, 5, 3],
      [3, 5, 5, 5, 5, 5, 5, 5, 5, 3],
      [3, 3, 3, 3, 3, 1, 3, 3, 3, 3]
    ],
    "decoration": [
      [0, 0, 0, 0, 0, 0, 0, 0, 0, 0],
      [0, 0, 0, 0, 0, 0, 0, 0, 0, 0],
      [0, 0, 0, 0, 0, 0, 0, 0, 0, 0],
      [0, 0, 0, 0, 0, 0, 0, 0, 0, 0],
      [0, 0, 0, 0, 0, 0, 0, 0, 0, 0],
      [0, 0, 0, 0, 0, 0, 0, 0, 0, 0],
      [0, 0, 0, 0, 0, 0, 0, 0, 0, 0],
      [0, 0, 0, 0, 0, 0, 0, 0, 0, 0]
    ],
    "collision": [
      [1, 1, 1, 1, 1, 0, 1, 1, 1, 1],
      [1, 0, 0, 0, 0, 0, 0, 0, 0, 1],
      [1, 0, 0, 0, 0, 0, 0, 0, 0, 1],
      [1, 0, 0, 0, 0, 0, 0, 0, 0, 1],
      [1, 0, 0, 0, 0, 0, 0, 0, 0, 1],
      [1, 0, 0, 0, 0, 0, 0, 0, 0, 1],
      [1, 0, 0, 0, 0, 0, 0, 0, 0, 1],
      [1, 1, 1, 1, 1, 0, 1, 1, 1, 1]
    ]
  },
  "transitions": [
    {
      "fromMapId": "mountain-lift",
      "fromTile": { "x": 5, "y": 7 },
      "toMapId": "ashbend-camp",
      "toTile": { "x": 12, "y": 1 }
    },
    {
      "fromMapId": "mountain-lift",
      "fromTile": { "x": 5, "y": 0 },
      "toMapId": "frostveil-path",
      "toTile": { "x": 5, "y": 13 }
    }
  ]
}
