{
  "id": "starter-town",
  "name": "Starter Town",
  "width": 22,
  "height": 14,
  "tileSize": 16,
  "tilesetId": "overworld",
  "spawnPoint": { "x": 5, "y": 10 },
  "layers": {
    "ground": [
      [1,1,1,1,1,1,1,1,1,1,1,1,1,1,1,1,1,1,1,1,1,1],
      [1,1,1,1,1,1,1,1,1,1,1,1,1,1,1,1,1,1,1,1,1,1],
      [1,1,2,2,2,2,2,2,1,1,1,1,1,1,1,1,2,2,2,2,2,2],
      [1,1,2,2,2,2,2,2,1,1,1,1,1,1,1,1,2,2,2,2,2,2],
      [1,1,1,1,1,1,2,1,1,1,1,1,1,1,1,1,2,1,1,1,1,1],
      [1,1,1,1,1,1,2,1,1,1,1,1,1,1,1,1,2,1,1,1,1,1],
      [1,1,1,1,1,1,2,2,2,2,2,2,2,2,2,2,2,1,1,1,1,1],
      [1,1,1,1,1,1,1,1,1,1,1,1,1,1,1,1,1,1,1,1,1,1],
      [1,1,2,2,2,2,1,1,1,1,1,1,1,1,1,1,1,1,2,2,2,2],
      [1,1,2,2,2,2,1,1,1,1,1,1,1,1,1,1,1,1,2,2,2,2],
      [1,1,2,2,2,2,1,1,1,1,1,1,1,1,1,1,1,1,2,2,2,2],
      [1,1,1,1,1,1,1,1,1,1,1,1,1,1,1,1,1,1,1,1,1,1],
      [1,1,1,1,1,1,1,1,1,1,1,1,1,1,1,1,1,1,1,1,1,1],
      [1,1,1,1,1,1,1,1,1,1,1,1,1,1,1,1,1,1,1,1,1,1]
    ],
    "decoration": [
      [0,0,0,0,0,0,0,0,0,0,0,0,0,0,0,0,0,0,0,0,0,0],
      [0,0,8,8,0,0,0,0,0,0,0,0,0,0,0,0,0,6,6,0,0,0],
      [0,0,8,8,0,0,0,0,0,0,0,0,0,0,0,0,0,6,6,0,0,0],
      [0,0,0,0,0,0,0,0,0,0,0,0,0,0,0,0,0,0,0,0,0,0],
      [0,0,0,0,0,0,6,0,0,0,0,0,0,0,0,0,6,0,0,0,0,0],
      [0,0,0,0,0,0,6,0,0,0,0,0,0,0,0,0,6,0,0,0,0,0],
      [0,0,0,0,0,0,0,0,0,0,0,0,0,0,0,0,0,0,0,0,0,0],
      [0,0,0,0,0,0,0,0,0,0,0,0,0,0,0,0,0,0,0,0,0,0],
      [0,0,0,0,0,0,0,0,0,0,7,0,0,7,0,0,0,0,0,0,0,0],
      [0,0,0,0,0,0,0,0,0,0,0,0,0,0,0,0,0,0,0,0,0,0],
      [0,0,0,0,0,0,0,0,0,0,0,0,0,0,0,0,0,0,0,0,0,0],
      [0,0,0,0,0,0,0,0,0,0,0,0,0,0,0,0,0,0,0,0,0,0],
      [0,0,0,0,0,0,0,0,0,0,0,0,0,0,0,0,0,0,0,0,0,0],
      [0,0,0,0,0,0,0,0,0,0,0,0,0,0,0,0,0,0,0,0,0,0]
    ],
    "collision": [
      [0,0,0,0,0,0,0,0,0,0,0,0,0,0,0,0,0,0,0,0,0,0],
      [0,0,1,1,0,0,0,0,0,0,0,0,0,0,0,0,0,1,1,0,0,0],
      [0,0,1,1,0,0,0,0,0,0,0,0,0,0,0,0,0,1,1,0,0,0],
      [0,0,0,0,0,0,0,0,0,0,0,0,0,0,0,0,0,0,0,0,0,0],
      [0,0,0,0,0,0,1,0,0,0,0,0,0,0,0,0,1,0,0,0,0,0],
      [0,0,0,0,0,0,1,0,0,0,0,0,0,0,0,0,1,0,0,0,0,0],
      [0,0,0,0,0,0,0,0,0,0,0,0,0,0,0,0,0,0,0,0,0,0],
      [0,0,0,0,0,0,0,0,0,0,0,0,0,0,0,0,0,0,0,0,0,0],
      [0,0,0,0,0,0,0,0,0,0,0,0,0,0,0,0,0,0,0,0,0,0],
      [0,0,0,0,0,0,0,0,0,0,0,0,0,0,0,0,0,0,0,0,0,0],
      [0,0,0,0,0,0,0,0,0,0,0,0,0,0,0,0,0,0,0,0,0,0],
      [0,0,0,0,0,0,0,0,0,0,0,0,0,0,0,0,0,0,0,0,0,0],
      [0,0,0,0,0,0,0,0,0,0,0,0,0,0,0,0,0,0,0,0,0,0],
      [0,0,0,0,0,0,0,0,0,0,0,0,0,0,0,0,0,0,0,0,0,0]
    ]
  },
  "transitions": [
    {
      "fromMapId": "starter-town",
      "fromTile": { "x": 10, "y": 0 },
      "toMapId": "route-1",
      "toTile": { "x": 10, "y": 12 },
      "requiredFlag": "received_starter"
    }
  ]
}