{
  "id": "abandoned-train",
  "name": "Abandoned Train",
  "width": 22,
  "height": 70,
  "tileSize": 16,
  "tilesetId": "overworld",
  "spawnPoint": { "x": 10, "y": 10 },
  "layers": {
    "ground": [
      [3,3,3,3,3,3,3,3,3,3,3,3,3,3,3,3,3,3,3,3,3,3],
      [3,3,3,3,3,3,3,3,3,3,3,3,3,3,3,3,3,3,3,3,3,3],
      [3,3,3,3,3,3,3,3,3,3,3,3,3,3,3,3,3,3,3,3,3,3],
      [3,3,3,3,3,3,3,3,3,3,3,3,3,3,3,3,3,3,3,3,3,3],
      [3,3,3,3,3,3,3,3,1,1,1,1,1,1,3,3,3,3,3,3,3,3],
      [3,3,3,3,3,3,3,3,1,2,2,2,2,1,3,3,3,3,3,3,3,3],
      [3,3,3,3,3,3,3,3,1,2,2,2,2,1,3,3,3,3,3,3,3,3],
      [3,3,3,3,3,3,3,3,1,2,2,2,2,1,3,3,3,3,3,3,3,3],
      [3,3,3,3,3,3,3,3,1,2,2,2,2,1,3,3,3,3,3,3,3,3],
      [3,3,3,3,3,3,3,3,1,2,2,2,2,1,3,3,3,3,3,3,3,3],
      [3,3,3,3,3,3,3,3,1,2,2,2,2,1,3,3,3,3,3,3,3,3],
      [3,3,3,3,3,3,3,3,1,1,1,1,1,1,3,3,3,3,3,3,3,3],
      [3,3,3,3,3,3,3,3,3,3,3,3,3,3,3,3,3,3,3,3,3,3],
      [3,3,3,3,3,3,3,3,3,3,3,3,3,3,3,3,3,3,3,3,3,3],
      [3,3,3,3,3,3,3,3,1,1,1,1,1,1,3,3,3,3,3,3,3,3],
      [3,3,3,3,3,3,3,3,1,2,2,2,2,1,3,3,3,3,3,3,3,3],
      [3,3,3,3,3,3,3,3,1,2,2,2,2,1,3,3,3,3,3,3,3,3],
      [3,3,3,3,3,3,3,3,1,2,2,2,2,1,3,3,3,3,3,3,3,3],
      [3,3,3,3,3,3,3,3,1,2,2,2,2,1,3,3,3,3,3,3,3,3],
      [3,3,3,3,3,3,3,3,1,2,2,2,2,1,3,3,3,3,3,3,3,3],
      [3,3,3,3,3,3,3,3,1,2,2,2,2,1,3,3,3,3,3,3,3,3],
      [3,3,3,3,3,3,3,3,1,2,2,2,2,1,3,3,3,3,3,3,3,3],
      [3,3,3,3,3,3,3,3,1,2,2,2,2,1,3,3,3,3,3,3,3,3],
      [3,3,3,3,3,3,3,3,1,2,2,2,2,1,3,3,3,3,3,3,3,3],
      [3,3,3,3,3,3,3,3,1,2,2,2,2,1,3,3,3,3,3,3,3,3],
      [3,3,3,3,3,3,3,3,1,1,1,1,1,1,3,3,3,3,3,3,3,3],
      [3,3,3,3,3,3,3,3,3,3,3,3,3,3,3,3,3,3,3,3,3,3],
      [3,3,3,3,3,3,3,3,3,3,3,3,3,3,3,3,3,3,3,3,3,3],
      [3,3,3,3,3,3,3,3,1,1,1,1,1,1,3,3,3,3,3,3,3,3],
      [3,3,3,3,3,3,3,3,1,2,2,2,2,1,3,3,3,3,3,3,3,3],
      [3,3,3,3,3,3,3,3,1,2,2,2,2,1,3,3,3,3,3,3,3,3],
      [3,3,3,3,3,3,3,3,1,2,2,2,2,1,3,3,3,3,3,3,3,3],
      [3,3,3,3,3,3,3,3,1,2,2,2,2,1,3,3,3,3,3,3,3,3],
      [3,3,3,3,3,3,3,3,1,2,2,2,2,1,3,3,3,3,3,3,3,3],
      [3,3,3,3,3,3,3,3,1,2,2,2,2,1,3,3,3,3,3,3,3,3],
      [3,3,3,3,3,3,3,3,1,2,2,2,2,1,3,3,3,3,3,3,3,3],
      [3,3,3,3,3,3,3,3,1,2,2,2,2,1,3,3,3,3,3,3,3,3],
      [3,3,3,3,3,3,3,3,1,2,2,2,2,1,3,3,3,3,3,3,3,3],
      [3,3,3,3,3,3,3,3,1,2,2,2,2,1,3,3,3,3,3,3,3,3],
      [3,3,3,3,3,3,3,3,1,1,1,1,1,1,3,3,3,3,3,3,3,3],
      [3,3,3,3,3,3,3,3,3,3,3,3,3,3,3,3,3,3,3,3,3,3],
      [3,3,3,3,3,3,3,3,3,3,3,3,3,3,3,3,3,3,3,3,3,3],
      [3,3,3,3,3,3,3,3,1,1,1,1,1,1,3,3,3,3,3,3,3,3],
      [3,3,3,3,3,3,3,3,1,2,2,2,2,1,3,3,3,3,3,3,3,3],
      [3,3,3,3,3,3,3,3,1,2,2,2,2,1,3,3,3,3,3,3,3,3],
      [3,3,3,3,3,3,3,3,1,2,2,2,2,1,3,3,3,3,3,3,3,3],
      [3,3,3,3,3,3,3,3,1,2,2,2,2,1,3,3,3,3,3,3,3,3],
      [3,3,3,3,3,3,3,3,1,2,2,2,2,1,3,3,3,3,3,3,3,3],
      [3,3,3,3,3,3,3,3,1,2,2,2,2,1,3,3,3,3,3,3,3,3],
      [3,3,3,3,3,3,3,3,1,2,2,2,2,1,3,3,3,3,3,3,3,3],
      [3,3,3,3,3,3,3,3,1,2,2,2,2,1,3,3,3,3,3,3,3,3],
      [3,3,3,3,3,3,3,3,1,2,2,2,2,1,3,3,3,3,3,3,3,3],
      [3,3,3,3,3,3,3,3,1,2,2,2,2,1,3,3,3,3,3,3,3,3],
      [3,3,3,3,3,3,3,3,1,1,1,1,1,1,3,3,3,3,3,3,3,3],
      [3,3,3,3,3,3,3,3,3,3,3,3,3,3,3,3,3,3,3,3,3,3],
      [3,3,3,3,3,3,3,3,3,3,3,3,3,3,3,3,3,3,3,3,3,3],
      [3,3,3,3,3,3,3,3,1,1,1,1,1,1,3,3,3,3,3,3,3,3],
      [3,3,3,3,3,3,3,3,1,2,2,2,2,1,3,3,3,3,3,3,3,3],
      [3,3,3,3,3,3,3,3,1,2,2,2,2,1,3,3,3,3,3,3,3,3],
      [3,3,3,3,3,3,3,3,1,2,2,2,2,1,3,3,3,3,3,3,3,3],
      [3,3,3,3,3,3,3,3,1,2,2,2,2,1,3,3,3,3,3,3,3,3],
      [3,3,3,3,3,3,3,3,1,2,2,2,2,1,3,3,3,3,3,3,3,3],
      [3,3,3,3,3,3,3,3,1,2,2,2,2,1,3,3,3,3,3,3,3,3],
      [3,3,3,3,3,3,3,3,1,2,2,2,2,1,3,3,3,3,3,3,3,3],
      [3,3,3,3,3,3,3,3,1,2,2,2,2,1,3,3,3,3,3,3,3,3],
      [3,3,3,3,3,3,3,3,1,2,2,2,2,1,3,3,3,3,3,3,3,3],
      [3,3,3,3,3,3,3,3,1,2,2,2,2,1,3,3,3,3,3,3,3,3],
      [3,3,3,3,3,3,3,3,1,1,1,1,1,1,3,3,3,3,3,3,3,3],
      [3,3,3,3,3,3,3,3,3,3,3,3,3,3,3,3,3,3,3,3,3,3],
      [3,3,3,3,3,3,3,3,3,3,3,3,3,3,3,3,3,3,3,3,3,3]
    ],
    "decoration": [
      [0,0,0,0,0,0,0,0,0,0,0,0,0,0,0,0,0,0,0,0,0,0],
      [0,0,0,0,0,0,0,0,0,0,0,0,0,0,0,0,0,0,0,0,0,0],
      [0,0,0,0,0,0,0,0,0,0,0,0,0,0,0,0,0,0,0,0,0,0],
      [0,0,0,0,0,0,0,0,0,0,0,0,0,0,0,0,0,0,0,0,0,0],
      [0,0,0,0,0,0,0,0,0,0,0,0,0,0,0,0,0,0,0,0,0,0],
      [0,0,0,0,0,0,0,0,0,0,0,0,0,0,0,0,0,0,0,0,0,0],
      [0,0,0,0,0,0,0,0,0,0,0,0,0,0,0,0,0,0,0,0,0,0],
      [0,0,0,0,0,0,0,0,0,0,0,0,0,0,0,0,0,0,0,0,0,0],
      [0,0,0,0,0,0,0,0,0,0,0,0,0,0,0,0,0,0,0,0,0,0],
      [0,0,0,0,0,0,0,0,0,0,0,0,0,0,0,0,0,0,0,0,0,0],
      [0,0,0,0,0,0,0,0,0,0,0,0,0,0,0,0,0,0,0,0,0,0],
      [0,0,0,0,0,0,0,0,0,0,0,0,0,0,0,0,0,0,0,0,0,0],
      [0,0,0,0,0,0,0,0,0,0,0,0,0,0,0,0,0,0,0,0,0,0],
      [0,0,0,0,0,0,0,0,0,0,0,0,0,0,0,0,0,0,0,0,0,0],
      [0,0,0,0,0,0,0,0,0,0,0,0,0,0,0,0,0,0,0,0,0,0],
      [0,0,0,0,0,0,0,0,0,0,0,0,0,0,0,0,0,0,0,0,0,0],
      [0,0,0,0,0,0,0,0,0,0,0,0,0,0,0,0,0,0,0,0,0,0],
      [0,0,0,0,0,0,0,0,0,0,0,0,0,0,0,0,0,0,0,0,0,0],
      [0,0,0,0,0,0,0,0,0,0,0,0,0,0,0,0,0,0,0,0,0,0],
      [0,0,0,0,0,0,0,0,0,0,0,0,0,0,0,0,0,0,0,0,0,0],
      [0,0,0,0,0,0,0,0,0,0,0,0,0,0,0,0,0,0,0,0,0,0],
      [0,0,0,0,0,0,0,0,0,0,0,0,0,0,0,0,0,0,0,0,0,0],
      [0,0,0,0,0,0,0,0,0,0,0,0,0,0,0,0,0,0,0,0,0,0],
      [0,0,0,0,0,0,0,0,0,0,0,0,0,0,0,0,0,0,0,0,0,0],
      [0,0,0,0,0,0,0,0,0,0,0,0,0,0,0,0,0,0,0,0,0,0],
      [0,0,0,0,0,0,0,0,0,0,0,0,0,0,0,0,0,0,0,0,0,0],
      [0,0,0,0,0,0,0,0,0,0,0,0,0,0,0,0,0,0,0,0,0,0],
      [0,0,0,0,0,0,0,0,0,0,0,0,0,0,0,0,0,0,0,0,0,0],
      [0,0,0,0,0,0,0,0,0,0,0,0,0,0,0,0,0,0,0,0,0,0],
      [0,0,0,0,0,0,0,0,0,0,0,0,0,0,0,0,0,0,0,0,0,0],
      [0,0,0,0,0,0,0,0,0,0,0,0,0,0,0,0,0,0,0,0,0,0],
      [0,0,0,0,0,0,0,0,0,0,0,0,0,0,0,0,0,0,0,0,0,0],
      [0,0,0,0,0,0,0,0,0,0,0,0,0,0,0,0,0,0,0,0,0,0],
      [0,0,0,0,0,0,0,0,0,0,0,0,0,0,0,0,0,0,0,0,0,0],
      [0,0,0,0,0,0,0,0,0,0,0,0,0,0,0,0,0,0,0,0,0,0],
      [0,0,0,0,0,0,0,0,0,0,0,0,0,0,0,0,0,0,0,0,0,0],
      [0,0,0,0,0,0,0,0,0,0,0,0,0,0,0,0,0,0,0,0,0,0],
      [0,0,0,0,0,0,0,0,0,0,0,0,0,0,0,0,0,0,0,0,0,0],
      [0,0,0,0,0,0,0,0,0,0,0,0,0,0,0,0,0,0,0,0,0,0],
      [0,0,0,0,0,0,0,0,0,0,0,0,0,0,0,0,0,0,0,0,0,0],
      [0,0,0,0,0,0,0,0,0,0,0,0,0,0,0,0,0,0,0,0,0,0],
      [0,0,0,0,0,0,0,0,0,0,0,0,0,0,0,0,0,0,0,0,0,0],
      [0,0,0,0,0,0,0,0,0,0,0,0,0,0,0,0,0,0,0,0,0,0],
      [0,0,0,0,0,0,0,0,0,0,0,0,0,0,0,0,0,0,0,0,0,0],
      [0,0,0,0,0,0,0,0,0,0,0,0,0,0,0,0,0,0,0,0,0,0],
      [0,0,0,0,0,0,0,0,0,0,0,0,0,0,0,0,0,0,0,0,0,0],
      [0,0,0,0,0,0,0,0,0,0,0,0,0,0,0,0,0,0,0,0,0,0],
      [0,0,0,0,0,0,0,0,0,0,0,0,0,0,0,0,0,0,0,0,0,0],
      [0,0,0,0,0,0,0,0,0,0,0,0,0,0,0,0,0,0,0,0,0,0],
      [0,0,0,0,0,0,0,0,0,0,0,0,0,0,0,0,0,0,0,0,0,0],
      [0,0,0,0,0,0,0,0,0,0,0,0,0,0,0,0,0,0,0,0,0,0],
      [0,0,0,0,0,0,0,0,0,0,0,0,0,0,0,0,0,0,0,0,0,0],
      [0,0,0,0,0,0,0,0,0,0,0,0,0,0,0,0,0,0,0,0,0,0],
      [0,0,0,0,0,0,0,0,0,0,0,0,0,0,0,0,0,0,0,0,0,0],
      [0,0,0,0,0,0,0,0,0,0,0,0,0,0,0,0,0,0,0,0,0,0],
      [0,0,0,0,0,0,0,0,0,0,0,0,0,0,0,0,0,0,0,0,0,0],
      [0,0,0,0,0,0,0,0,0,0,0,0,0,0,0,0,0,0,0,0,0,0],
      [0,0,0,0,0,0,0,0,0,0,0,0,0,0,0,0,0,0,0,0,0,0],
      [0,0,0,0,0,0,0,0,0,0,0,0,0,0,0,0,0,0,0,0,0,0],
      [0,0,0,0,0,0,0,0,0,0,0,0,0,0,0,0,0,0,0,0,0,0],
      [0,0,0,0,0,0,0,0,0,0,0,0,0,0,0,0,0,0,0,0,0,0],
      [0,0,0,0,0,0,0,0,0,0,0,0,0,0,0,0,0,0,0,0,0,0],
      [0,0,0,0,0,0,0,0,0,0,0,0,0,0,0,0,0,0,0,0,0,0],
      [0,0,0,0,0,0,0,0,0,0,0,0,0,0,0,0,0,0,0,0,0,0],
      [0,0,0,0,0,0,0,0,0,0,0,0,0,0,0,0,0,0,0,0,0,0],
      [0,0,0,0,0,0,0,0,0,0,0,0,0,0,0,0,0,0,0,0,0,0],
      [0,0,0,0,0,0,0,0,0,0,0,0,0,0,0,0,0,0,0,0,0,0],
      [0,0,0,0,0,0,0,0,0,0,0,0,0,0,0,0,0,0,0,0,0,0],
      [0,0,0,0,0,0,0,0,0,0,0,0,0,0,0,0,0,0,0,0,0,0],
      [0,0,0,0,0,0,0,0,0,0,0,0,0,0,0,0,0,0,0,0,0,0]
    ],
    "collision": [
      [1,1,1,1,1,1,1,1,1,1,1,1,1,1,1,1,1,1,1,1,1,1],
      [1,1,1,1,1,1,1,1,1,1,1,1,1,1,1,1,1,1,1,1,1,1],
      [1,1,1,1,1,1,1,1,1,1,1,1,1,1,1,1,1,1,1,1,1,1],
      [1,1,1,1,1,1,1,1,1,1,1,1,1,1,1,1,1,1,1,1,1,1],
      [1,1,1,1,1,1,1,1,0,1,1,1,1,1,1,1,1,1,1,1,1,1],
      [1,1,1,1,1,1,1,1,1,0,0,0,0,1,1,1,1,1,1,1,1,1],
      [1,1,1,1,1,1,1,1,1,0,0,0,0,1,1,1,1,1,1,1,1,1],
      [1,1,1,1,1,1,1,1,1,0,0,0,0,1,1,1,1,1,1,1,1,1],
      [1,1,1,1,1,1,1,1,1,0,0,0,0,1,1,1,1,1,1,1,1,1],
      [1,1,1,1,1,1,1,1,1,0,0,0,0,1,1,1,1,1,1,1,1,1],
      [1,1,1,1,1,1,1,1,1,0,0,0,0,1,1,1,1,1,1,1,1,1],
      [1,1,1,1,1,1,1,1,1,1,0,1,1,1,1,1,1,1,1,1,1,1],
      [1,1,1,1,1,1,1,1,1,1,1,1,1,1,1,1,1,1,1,1,1,1],
      [1,1,1,1,1,1,1,1,1,1,1,1,1,1,1,1,1,1,1,1,1,1],
      [1,1,1,1,1,1,1,1,1,1,0,1,1,1,1,1,1,1,1,1,1,1],
      [1,1,1,1,1,1,1,1,1,0,0,0,0,1,1,1,1,1,1,1,1,1],
      [1,1,1,1,1,1,1,1,1,0,0,0,0,1,1,1,1,1,1,1,1,1],
      [1,1,1,1,1,1,1,1,1,0,0,0,0,1,1,1,1,1,1,1,1,1],
      [1,1,1,1,1,1,1,1,1,0,0,0,0,1,1,1,1,1,1,1,1,1],
      [1,1,1,1,1,1,1,1,1,0,0,0,0,1,1,1,1,1,1,1,1,1],
      [1,1,1,1,1,1,1,1,1,0,0,0,0,1,1,1,1,1,1,1,1,1],
      [1,1,1,1,1,1,1,1,1,0,0,0,0,1,1,1,1,1,1,1,1,1],
      [1,1,1,1,1,1,1,1,1,0,0,0,0,1,1,1,1,1,1,1,1,1],
      [1,1,1,1,1,1,1,1,1,0,0,0,0,1,1,1,1,1,1,1,1,1],
      [1,1,1,1,1,1,1,1,1,0,0,0,0,1,1,1,1,1,1,1,1,1],
      [1,1,1,1,1,1,1,1,1,1,0,1,1,1,1,1,1,1,1,1,1,1],
      [1,1,1,1,1,1,1,1,1,1,1,1,1,1,1,1,1,1,1,1,1,1],
      [1,1,1,1,1,1,1,1,1,1,1,1,1,1,1,1,1,1,1,1,1,1],
      [1,1,1,1,1,1,1,1,1,1,0,1,1,1,1,1,1,1,1,1,1,1],
      [1,1,1,1,1,1,1,1,1,0,0,0,0,1,1,1,1,1,1,1,1,1],
      [1,1,1,1,1,1,1,1,1,0,0,0,0,1,1,1,1,1,1,1,1,1],
      [1,1,1,1,1,1,1,1,1,0,0,0,0,1,1,1,1,1,1,1,1,1],
      [1,1,1,1,1,1,1,1,1,0,0,0,0,1,1,1,1,1,1,1,1,1],
      [1,1,1,1,1,1,1,1,1,0,0,0,0,1,1,1,1,1,1,1,1,1],
      [1,1,1,1,1,1,1,1,1,0,0,0,0,1,1,1,1,1,1,1,1,1],
      [1,1,1,1,1,1,1,1,1,0,0,0,0,1,1,1,1,1,1,1,1,1],
      [1,1,1,1,1,1,1,1,1,0,0,0,0,1,1,1,1,1,1,1,1,1],
      [1,1,1,1,1,1,1,1,1,0,0,0,0,1,1,1,1,1,1,1,1,1],
      [1,1,1,1,1,1,1,1,1,0,0,0,0,1,1,1,1,1,1,1,1,1],
      [1,1,1,1,1,1,1,1,1,1,0,1,1,1,1,1,1,1,1,1,1,1],
      [1,1,1,1,1,1,1,1,1,1,1,1,1,1,1,1,1,1,1,1,1,1],
      [1,1,1,1,1,1,1,1,1,1,1,1,1,1,1,1,1,1,1,1,1,1],
      [1,1,1,1,1,1,1,1,1,1,0,1,1,1,1,1,1,1,1,1,1,1],
      [1,1,1,1,1,1,1,1,1,0,0,0,0,1,1,1,1,1,1,1,1,1],
      [1,1,1,1,1,1,1,1,1,0,0,0,0,1,1,1,1,1,1,1,1,1],
      [1,1,1,1,1,1,1,1,1,0,0,0,0,1,1,1,1,1,1,1,1,1],
      [1,1,1,1,1,1,1,1,1,0,0,0,0,1,1,1,1,1,1,1,1,1],
      [1,1,1,1,1,1,1,1,1,0,0,0,0,1,1,1,1,1,1,1,1,1],
      [1,1,1,1,1,1,1,1,1,0,0,0,0,1,1,1,1,1,1,1,1,1],
      [1,1,1,1,1,1,1,1,1,0,0,0,0,1,1,1,1,1,1,1,1,1],
      [1,1,1,1,1,1,1,1,1,0,0,0,0,1,1,1,1,1,1,1,1,1],
      [1,1,1,1,1,1,1,1,1,0,0,0,0,1,1,1,1,1,1,1,1,1],
      [1,1,1,1,1,1,1,1,1,0,0,0,0,1,1,1,1,1,1,1,1,1],
      [1,1,1,1,1,1,1,1,1,1,0,1,1,1,1,1,1,1,1,1,1,1],
      [1,1,1,1,1,1,1,1,1,1,1,1,1,1,1,1,1,1,1,1,1,1],
      [1,1,1,1,1,1,1,1,1,1,1,1,1,1,1,1,1,1,1,1,1,1],
      [1,1,1,1,1,1,1,1,1,1,0,1,1,1,1,1,1,1,1,1,1,1],
      [1,1,1,1,1,1,1,1,1,0,0,0,0,1,1,1,1,1,1,1,1,1],
      [1,1,1,1,1,1,1,1,1,0,0,0,0,1,1,1,1,1,1,1,1,1],
      [1,1,1,1,1,1,1,1,1,0,0,0,0,1,1,1,1,1,1,1,1,1],
      [1,1,1,1,1,1,1,1,1,0,0,0,0,1,1,1,1,1,1,1,1,1],
      [1,1,1,1,1,1,1,1,1,0,0,0,0,1,1,1,1,1,1,1,1,1],
      [1,1,1,1,1,1,1,1,1,0,0,0,0,1,1,1,1,1,1,1,1,1],
      [1,1,1,1,1,1,1,1,1,0,0,0,0,1,1,1,1,1,1,1,1,1],
      [1,1,1,1,1,1,1,1,1,0,0,0,0,1,1,1,1,1,1,1,1,1],
      [1,1,1,1,1,1,1,1,1,0,0,0,0,1,1,1,1,1,1,1,1,1],
      [1,1,1,1,1,1,1,1,1,0,0,0,0,1,1,1,1,1,1,1,1,1],
      [1,1,1,1,1,1,1,1,1,1,1,1,1,1,1,1,1,1,1,1,1,1],
      [1,1,1,1,1,1,1,1,1,1,1,1,1,1,1,1,1,1,1,1,1,1],
      [1,1,1,1,1,1,1,1,1,1,1,1,1,1,1,1,1,1,1,1,1,1]
    ]
  },
  "triggers": [
    {
      "id": "train-lever-1",
      "kind": "switch",
      "tile": { "x": 9, "y": 20 },
      "setsFlag": "train_lever_1",
      "message": "You pulled the lever in the cargo car! A heavy door slides open down the corridor.",
      "alreadyMessage": "The lever is already pulled."
    },
    {
      "id": "train-lever-2",
      "kind": "switch",
      "tile": { "x": 12, "y": 34 },
      "setsFlag": "train_lever_2",
      "message": "You flipped the panel switch! The door block is cleared.",
      "alreadyMessage": "The switch is already flipped."
    },
    {
      "id": "train-lever-3",
      "kind": "switch",
      "tile": { "x": 12, "y": 50 },
      "setsFlag": "train_lever_3",
      "message": "You engaged the engine bypass! The boss carriage door unlocks.",
      "alreadyMessage": "The bypass is already active."
    },
    {
      "id": "dungeon-door-1",
      "kind": "lockedDoor",
      "tile": { "x": 10, "y": 25 },
      "requiredFlag": "train_lever_1",
      "doorTiles": [
        { "x": 10, "y": 25 }
      ],
      "message": "The door to Carriage 3 is open.",
      "blockedMessage": "The door is locked electronically. You need to pull the lever in this cargo car.",
      "alreadyMessage": "The door is already open."
    },
    {
      "id": "dungeon-door-2",
      "kind": "lockedDoor",
      "tile": { "x": 10, "y": 39 },
      "requiredFlag": "train_lever_2",
      "doorTiles": [
        { "x": 10, "y": 39 }
      ],
      "message": "The door to Carriage 4 is open.",
      "blockedMessage": "The door is locked. Find the panel switch in this carriage.",
      "alreadyMessage": "The door is already open."
    },
    {
      "id": "dungeon-door-3",
      "kind": "lockedDoor",
      "tile": { "x": 10, "y": 53 },
      "requiredFlag": "train_lever_3",
      "doorTiles": [
        { "x": 10, "y": 53 }
      ],
      "message": "The door to the Engine Room is open.",
      "blockedMessage": "The door is locked. Find the engine bypass switch.",
      "alreadyMessage": "The door is already open."
    },
    {
      "id": "train-rest-bench",
      "kind": "healingSpring",
      "tile": { "x": 9, "y": 48 },
      "message": "You sat on the passenger rest bench. Your JoyMon party was fully healed!"
    }
  ],
  "transitions": [
    {
      "fromMapId": "abandoned-train",
      "fromTile": { "x": 10, "y": 11 },
      "toMapId": "bloomrail-station",
      "toTile": { "x": 10, "y": 6 }
    },
    {
      "fromMapId": "abandoned-train",
      "fromTile": { "x": 10, "y": 4 },
      "toMapId": "abandoned-train",
      "toTile": { "x": 10, "y": 15 }
    },
    {
      "fromMapId": "abandoned-train",
      "fromTile": { "x": 10, "y": 14 },
      "toMapId": "abandoned-train",
      "toTile": { "x": 10, "y": 5 }
    },
    {
      "fromMapId": "abandoned-train",
      "fromTile": { "x": 10, "y": 25 },
      "toMapId": "abandoned-train",
      "toTile": { "x": 10, "y": 29 },
      "requiredFlag": "train_lever_1"
    },
    {
      "fromMapId": "abandoned-train",
      "fromTile": { "x": 10, "y": 28 },
      "toMapId": "abandoned-train",
      "toTile": { "x": 10, "y": 24 }
    },
    {
      "fromMapId": "abandoned-train",
      "fromTile": { "x": 10, "y": 39 },
      "toMapId": "abandoned-train",
      "toTile": { "x": 10, "y": 43 },
      "requiredFlag": "train_lever_2"
    },
    {
      "fromMapId": "abandoned-train",
      "fromTile": { "x": 10, "y": 42 },
      "toMapId": "abandoned-train",
      "toTile": { "x": 10, "y": 38 }
    },
    {
      "fromMapId": "abandoned-train",
      "fromTile": { "x": 10, "y": 53 },
      "toMapId": "abandoned-train",
      "toTile": { "x": 10, "y": 57 },
      "requiredFlag": "train_lever_3"
    },
    {
      "fromMapId": "abandoned-train",
      "fromTile": { "x": 10, "y": 56 },
      "toMapId": "abandoned-train",
      "toTile": { "x": 10, "y": 52 }
    }
  ]
}
