{
  "id": "mill-road",
  "name": "Mill Road",
  "width": 22,
  "height": 14,
  "tileSize": 16,
  "tilesetId": "overworld",
  "spawnPoint": { "x": 1, "y": 7 },
  "layers": {
    "ground": [
      [1,1,1,1,1,1,1,1,1,1,1,1,1,1,1,1,1,1,1,1,1,1],
      [1,1,1,1,1,1,1,1,1,1,1,1,1,1,1,1,1,1,1,1,1,1],
      [1,1,1,1,1,1,1,1,1,1,1,1,1,1,1,1,1,1,1,1,1,1],
      [1,1,1,1,1,1,1,1,1,1,1,1,1,1,1,1,1,1,1,1,1,1],
      [1,1,1,1,1,1,1,1,1,1,1,1,1,1,1,1,1,1,1,1,1,1],
      [1,1,1,1,1,1,1,2,1,1,1,1,1,1,1,1,1,1,1,1,1,1],
      [1,1,1,1,1,1,1,2,1,1,1,1,2,1,1,1,1,2,1,1,1,1],
      [2,2,2,2,2,2,2,2,2,2,2,2,2,2,2,2,2,2,2,2,2,1],
      [1,1,1,1,1,1,1,1,1,1,2,1,2,1,1,1,1,2,1,1,1,1],
      [1,1,1,1,1,1,1,1,1,1,2,1,2,1,1,1,1,1,1,1,1,1],
      [1,1,1,1,1,1,1,1,1,1,2,1,1,1,1,1,1,1,1,1,1,1],
      [1,1,1,1,1,1,1,1,1,1,2,1,1,1,1,1,1,1,1,1,1,1],
      [1,1,1,1,1,1,1,1,1,1,2,1,1,1,1,1,1,1,1,1,1,1],
      [1,1,1,1,1,1,1,1,1,1,2,1,1,1,1,1,1,1,1,1,1,1]
    ],
    "decoration": [
      [6,6,6,6,6,6,6,6,6,6,6,6,6,6,6,6,6,6,6,6,6,6],
      [6,0,0,0,0,0,0,0,0,0,0,0,0,0,0,0,0,0,0,0,0,6],
      [6,0,0,0,0,0,0,0,0,0,0,0,0,0,0,0,0,0,0,0,0,6],
      [6,0,0,0,0,0,0,0,0,0,0,0,0,0,0,0,0,0,0,0,0,6],
      [6,0,0,0,0,0,0,0,0,0,0,0,0,0,0,0,0,0,0,0,0,6],
      [6,0,0,0,0,0,0,0,0,0,0,0,0,0,0,0,0,0,0,0,0,6],
      [6,0,0,0,0,0,0,0,0,0,0,0,0,0,0,0,0,0,0,0,7,6],
      [0,0,0,0,0,0,0,0,0,0,0,0,0,0,0,0,0,0,0,0,0,6],
      [6,0,0,0,0,0,0,0,0,0,0,0,0,0,0,0,0,0,0,0,0,6],
      [6,0,0,0,0,0,0,0,0,0,0,0,0,0,0,0,0,0,0,0,0,6],
      [6,0,0,0,0,0,0,0,0,0,0,0,0,0,0,0,0,0,0,0,0,6],
      [6,0,0,0,0,0,0,0,0,0,0,0,0,0,0,0,0,0,0,0,0,6],
      [6,0,0,0,0,0,0,0,0,0,0,0,0,0,0,0,0,0,0,0,0,6],
      [6,6,6,6,6,6,6,6,6,6,0,6,6,6,6,6,6,6,6,6,6,6]
    ],
    "collision": [
      [1,1,1,1,1,1,1,1,1,1,1,1,1,1,1,1,1,1,1,1,1,1],
      [1,1,1,1,1,1,1,1,1,1,1,1,1,1,1,1,1,1,1,1,1,1],
      [1,1,1,1,1,1,1,1,1,1,1,1,1,1,1,1,1,1,1,1,1,1],
      [1,1,1,1,1,1,1,1,1,1,1,1,1,1,1,1,1,1,1,1,1,1],
      [1,1,1,1,1,1,1,1,1,1,1,1,1,1,1,1,1,1,1,1,1,1],
      [1,1,1,1,1,1,1,0,1,1,1,1,1,1,1,1,1,1,1,1,1,1],
      [1,1,1,1,1,1,1,0,1,1,1,1,0,1,1,1,1,0,1,1,1,1],
      [0,0,0,0,0,0,0,0,0,0,0,0,0,0,0,0,0,0,0,0,0,1],
      [1,1,1,1,1,1,1,1,1,1,0,1,0,1,1,1,1,0,1,1,1,1],
      [1,1,1,1,1,1,1,1,1,1,0,1,0,1,1,1,1,1,1,1,1,1],
      [1,1,1,1,1,1,1,1,1,1,0,1,1,1,1,1,1,1,1,1,1,1],
      [1,1,1,1,1,1,1,1,1,1,0,1,1,1,1,1,1,1,1,1,1,1],
      [1,1,1,1,1,1,1,1,1,1,0,1,1,1,1,1,1,1,1,1,1,1],
      [1,1,1,1,1,1,1,1,1,1,0,1,1,1,1,1,1,1,1,1,1,1]
    ]
  },
  "transitions": [
    {
      "fromMapId": "mill-road",
      "fromTile": { "x": 0, "y": 7 },
      "toMapId": "route-1",
      "toTile": { "x": 19, "y": 7 }
    },
    {
      "fromMapId": "mill-road",
      "fromTile": { "x": 20, "y": 7 },
      "toMapId": "old-watermill",
      "toTile": { "x": 1, "y": 7 }
    },
    {
      "fromMapId": "mill-road",
      "fromTile": { "x": 10, "y": 13 },
      "toMapId": "riverside-village",
      "toTile": { "x": 10, "y": 0 }
    }
  ]
}
